00000000000000000000000000000000000000000000000000
00000000000000000000000000000000000000000000000000
000000000000000000000000000000XXXXXXXX000000000000
0000000XXX0000000000000000000000000000000000000000
0000000000000000000XXXXXXXX000000000XXXXXXXX000000
0000XXXX000000000000000000000000000000000000000000
00000000000000000000000000000000000000000000000000
00XXX000000XXXXXXXXXX000000XXXXXXXXX00000000000000
00000000000000000000000000000000000000000000000000
YYYYYYYYYYYYYYYYYYYYYYYYYYYYYYYYYYYYYYYYYYYYYYYYYYYYYYYYYYYYYYYYY