0000000000
0000000000
0000000000
0000000000
0000000000
00x00xxxx0
00x00x0000
00X00x0000
00x00x0000
YYYYYYYYYY