0000000000
0X000000X0
00X0000X00
000X00X000
0000XX0000
0000XX0000
000X00X000
00X0000X00
0X000000X0
YYYYYYYYYY